6 3 4 0 7 7 2 6 0 4 
2 0 0 1 6 6 1 0 3 4 
2 8 7 2 0 4 7 0 2 0 
8 5 3 4 2 1 3 2 5 6 
8 3 5 1 5 3 5 7 2 8 
4 1 3 1 6 8 6 8 7 0 
8 2 1 2 0 1 0 8 2 4 
1 5 3 4 2 3 6 7 0 4 
3 1 4 6 7 8 4 4 4 7 
4 8 6 2 0 1 5 8 1 6 
